   C 255,20 ,30
NO      ./textures/eagle.xpm
SO ./textures/greystone.xpm
EA ./textures/red.xpm
WE ./textures/purplestone.xpm

   F 0000, 000, 00

11111111111111111111
11000000000000000001
10000000000000000011
11000010000000000001
10000111111100000001
1111111000000000W001
11110000000000110001
11000000000001111001
10000000000011100001
11000000000011100001
11000000000011100001
11000000000111100001
11111111111111111111
