
C 100,100,225
NO ./textures/eagle.xpm
EA ./textures/red.xpm
WE ./textures/purplestone.xpm
F 255,120,20
SO ./textures/greystone.xpm

111111111111111111111111111111
111111111000000000000000011111
111111111000000000000000011111
111111111000000000000000011111
111111111000000000000000011111
111111111000000000000000011111
111111111000000000000000011111
111111111000000000000000011111
111111111000000000000000011111
111111111000000000000000011111
111111111000000000000000011111
111111111000000000000000011111
111111111000000000000000011111
111111111000000000000000011111
1111111110000000000N000011111
111111111000000000000000011111
111111111000000000000000011111
111111111000000000000000011111
111111111000000000000000011111
111111111000000000000000011111
111111111000000000000000011111
111111111000000000000000011111
111111111000000000000000011111
111111111000000000000000011111
111111111000000000000000011111
111111111000000000000000011111
111111111000000000000000011111
111111111000000000000000011111
111111111000000000000000011111
111111111000000000000000011111
111111111000000000000000011111
111111111000000000000000011111
111111111000000000000000011111
111111111000000000000000011111
111111111000000000000000011111
111111111000000000000000011111
111111111000000000000000011111
111111111000000000000000011111
111111111000000000000000011111
111111111000000000000000011111
111111111000000000000000011111
111111111000000000000000011111
111111111000000000000000011111
111111111000000000000000011111
111111111000000000000000011111
111111111000000000000000011111
111111111000000000000000011111
111111111000000000000000011111
111111111000000000000000011111
111111111000000000000000011111
111111111000000000000000011111
111111111000000000000000011111
111111111000000000000000011111
111111111000000000000000011111
111111111000000000000000011111
111111111000000000000000011111
111111111000000000000000011111
111111111000000000000000011111
111111111000000000000000011111
111111111000000000000000011111
111111111000000000000000011111
111111111000000000000000011111
111111111000000000000000011111
111111111000000000000000011111
111111111000000000000000011111
111111111000000000000000011111
111111111000000000000000011111
111111111000000000000000011111
111111111000000000000000011111
111111111000000000000000011111
111111111000000000000000011111
111111111000000000000000011111
111111111000000000000000011111
111111111000000000000000011111
111111111000000000000000011111
111111111000000000000000011111
111111111000000000000000011111
111111111000000000000000011111
111111111000000000000000011111
111111111000000000000000011111
111111111000000000000000011111
111111111000000000000000011111
111111111000000000000000011111
111111111000000000000000011111
111111111000000000000000011111
111111111000000000000000011111
111111111000000000000000011111
111111111000000000000000011111
111111111000000000000000011111
111111111000000000000000011111
111111111000000000000000011111
111111111000000000000000011111
111111111000000000000000011111
111111111000000000000000011111
111111111000000000000000011111
111111111000000000000000011111
111111111000000000000000011111
111111111000000000000000011111
111111111000000000000000011111
111111111000000000000000011111
111111111000000000000000011111
111111111000000000000000011111
111111111000000000000000011111
111111111000000000000000011111
111111111000000000000000011111
111111111000000000000000011111
111111111000000000000000011111
111111111000000000000000011111
111111111000000000000000011111
111111111000000000000000011111
111111111000000000000000011111
111111111000000000000000011111
111111111000000000000000011111
111111111000000000000000011111
111111111000000000000000011111
111111111000000000000000011111
111111111000000000000000011111
111111111000000000000000011111
111111111000000000000000011111
111111111000000000000000011111
111111111000000000000000011111
111111111000000000000000011111
111111111000000000000000011111
111111111000000000000000011111
111111111000000000000000011111
111111111000000000000000011111
111111111000000000000000011111
111111111000000000000000011111
111111111000000000000000011111
111111111000000000000000011111
111111111000000000000000011111
111111111000000000000000011111
111111111000000000000000011111
111111111000000000000000011111
111111111000000000000000011111
111111111000000000000000011111
111111111000000000000000011111
111111111000000000000000011111
111111111000000000000000011111
111111111000000000000000011111
111111111000000000000000011111
111111111000000000000000011111
111111111111111111111111111111
