
C 100,100,225
NO ./textures/eagle.xpm
EA ./textures/red.xpm
WE ./textures/purplestone.xpm
F 255,120,20
SO ./textures/greystone.xpm

111111111111111111111111111111
111111111000000000000000011111
100000000000000000111000100001
110000100000000000000000001111
10000111111100000000000111111
1111111000000000W0000000000001
111100000000001100000000000011
1  0000000000     000000000011
110000000000011110000000000011
100000000000111000000000000011
110000000000111000000000001111
110000000001111000000000000111
111111000000000000000011111111
111111111000000000000000011111
100000000000000000111000100001
110000100000000000000000001111
10000111111100000000000111111
11111110000000000000000000001
111100000000001100000000000011
1  0000000000     000000000011
110000000000011110000000000011
100000000000111000000000000011
110000000000111000000000001111
110000000001111000000000000111
111100000000000000000000001111
111100000000000000000000001111
111111111000000000000000011111
100000000000000000111000100001
110000100000000000000000001111
10000111111100000000000111111
11111110000000000000000000001
111100000000001100000000000011
1  0000000000     000000000011
110000000000011110000000000011
1  0000000000     000000000011
110000000000011110000000000011
100000000000111000000000000011
110000000000111000000000001111
110000000001111000000000000111
111100000000000000000000001111
111100000000000000000000001111
111111111000000000000000011111
100000000000000000111000100001
110000100000000000000000001111
10000111111100000000000111111
11111110000000000000000000001
111100000000001100000000000011
1  0000000000     000000000011
110000000000011110000000000011
1  0000000000     000000000011
110000000000011110000000000011
100000000000111000000000000011
110000000000111000000000001111
110000000001111000000000000111
111100000000000000000000001111
111100000000000000000000001111
111111111000000000000000011111
100000000000000000111000100001
110000100000000000000000001111
10000111111100000000000111111
11111110000000000000000000001
111100000000001100000000000011
1  0000000000     000000000011
110000000000011110000000000011
1  0000000000     000000000011
110000000000011110000000000011
100000000000111000000000000011
110000000000111000000000001111
110000000001111000000000000111
111100000000000000000000001111
111100000000000000000000001111
111111111000000000000000011111
100000000000000000111000100001
110000100000000000000000001111
10000111111100000000000111111
11111110000000000000000000001
111100000000001100000000000011
1  0000000000     000000000011
110000000000011110000000000011
1  0000000000     000000000011
110000000000011110000000000011
100000000000111000000000000011
110000000000111000000000001111
110000000001111000000000000111
111100000000000000000000001111
111100000000000000000000001111
111111111000000000000000011111
100000000000000000111000100001
110000100000000000000000001111
10000111111100000000000111111
11111110000000000000000000001
11111111111111111111111111111
