
C 100,100,225
NO ./textures/eagle.xpm
EA ./textures/red.xpm
WE ./textures/purplestone.xpm
F 255,120,20
SO ./textures/greystone.xpm

111111111111111111111111111111111111111111111111111111111111111111111111111111111111111111111111111111111111111111
111111111000000000000000000000000000000000000000000000000000000000000000000000000000000000000000000000000000011111
100000000000000000111000100000000000000000000000000000000000000000000000000000000000000000000000000000000000001
110000100000000000000000000000000000000000000000000000000000000000000000000000000000000000000000000000000001111
10000111111100000000000000000000000000000000000000000000000000000000000000000000000000000000000000000000111111
1111111000000000W0000000000000000000000000000000000000000000000000000000000000000000000000000000000000000000001
111100000000001100000000000000000000000000000000000000000000000000000000000000000000000000000000000000000000011
1  0000000000     0000000000000000000000000000000000000000000000000000000000000000000000000000000000000000000011
1100000000000111100000000000000000000000000000000000000000000000000000000000000000000000000000000000000000000011
1000000000001110000000000000000000000000000000000000000000000000000000000000000000000000000000000000000000000011
1100000000001110000000000000000000000000000000000000000000000000000000000000000000000000000000000000000000001111
1100000000011110000000000000000000000000000000000000000000000000000000000000000000000000000000000000000000000111
1111110000000000000000000000000000000000000000000000000000000000000000000000000000000000000000000000000011111111
1111111110000000000000000000000000000000000000000000000000000000000000000000000000000000000000000000000000011111
1000000000000000000000000000000000000000000000000000000000000000000000000000000000000000000000000000111000100001
1100001000000000000000000000000000000000000000000000000000000000000000000000000000000000000000000000000000001111
100001111111000000000000000000000000000000000000000000000000000000000000000000000000000000000000000000000111111
111111100000000000000000000000000000000000000000000000000000000000000000000000000000000000000000000000000000001
1111000000000011000000000000000000000000000000000000000000000000000000000000000000000000000000000000000000000011
1  0000000000     0000000000000000000000000000000000000000000000000000000000000000000000000000000000000000000011
1100000000000111100000000000000000000000000000000000000000000000000000000000000000000000000000000000000000000011
1000000000001110000000000000000000000000000000000000000000000000000000000000000000000000000000000000000000000011
1100000000001110000000000000000000000000000000000000000000000000000000000000000000000000000000000000000000001111
1100000000011110000000000000000000000000000000000000000000000000000000000000000000000000000000000000000000000111
1111000000000000000000000000000000000000000000000000000000000000000000000000000000000000000000000000000000001111
1111000000000000000000000000000000000000000000000000000000000000000000000000000000000000000000000000000000001111
1111111110000000000000000000000000000000000000000000000000000000000000000000000000000000000000000000000000011111
1000000000000000001110000000000000000000000000000000000000000000000000000000000000000000000000000000000000100001
1100001000000000000000000000000000000000000000000000000000000000000000000000000000000000000000000000000000001111
100001111111000000000000000000000000000000000000000000000000000000000000000000000000000000000000000000000111111
111111100000000000000000000000000000000000000000000000000000000000000000000000000000000000000000000000000000001
1111000000000011000000000000000000000000000000000000000000000000000000000000000000000000000000000000000000000011
1  0000000000     0000000000000000000000000000000000000000000000000000000000000000000000000000000000000000000011
1100000000000111100000000000000000000000000000000000000000000000000000000000000000000000000000000000000000000011
1  0000000000     0000000000000000000000000000000000000000000000000000000000000000000000000000000000000000000011
1100000000000111100000000000000000000000000000000000000000000000000000000000000000000000000000000000000000000011
1000000000001110000000000000000000000000000000000000000000000000000000000000000000000000000000000000000000000011
1100000000001110000000000000000000000000000000000000000000000000000000000000000000000000000000000000000000001111
1100000000011110000000000000000000000000000000000000000000000000000000000000000000000000000000000000000000000111
111100000000000000000000000000000000000000000000000000000000000000000000000000000000000000000000000000000001111
1111000000000000000000000000000000000000000000000000000000000000000000000000000000000000000000000000000000001111
1111111110000000000000000000000000000000000000000000000000000000000000000000000000000000000000000000000000011111
1000000000000000001110000000000000000000000000000000000000000000000000000000000000000000000000000000000000100001
1111111111111111111111111111111111111111111111111111111111111111111111111111111111111111111111111111111111111111
